Shikanoko Nokonoko Koshitantan
11,11,7,6,8,4
1,1,1,1,1,1,1,1,1,1,1
1,1,0,0,0,0,0,0,0,0,1
1,0,0,0,0,1,0,1,0,0,1
1,0,0,0,1,0,0,0,1,0,1
1,0,1,0,0,0,0,0,0,0,1
1,0,0,0,1,0,0,0,9,1,1
1,0,0,0,0,1,0,0,0,1,1
1,0,0,0,0,1,0,0,0,0,1
1,0,0,0,0,0,0,0,1,0,1
1,0,0,1,0,1,1,0,0,0,1
1,1,1,1,1,1,1,1,1,1,1